111111111111111111111111111111
1P000C0C00C000C0C00C0C000C0001
101111111011111111101111111101
1C0000C0000C0000C0000C0000C0C1
101011101010111010101110101101
1C0C00C0C00C0C00C0C00C0C00C0C1
101111101110111011101111011101
1C0000C0000C0000C0000C0000C0C1
101011101010111010101110101101
1C0C00C0C00C0C00C0C00C0C00C0C1
101111111011111111101111111101
1C0000C0000C0000C0000C0000C0C1
1000000000000000000000000000E1
111111111111111111111111111111