111111
1P0C01
101101
1C0E01
111111