1111111111111111111111111111111111111111
1P01000100010001000100010001000100010001
10000CCC00010CCC00010CCC00010CCC00010001
1101111111011111110111111101111111011111
10010001C001000100010001C001000100010001
1001000000010001000100010001000100010001
10010CCC00010CCC00010CCC00010CCC00010001
1101111111011111110111111101111111011111
1001000100000001C00100010000000100010001
100100C100010001000100C10001000100000001
10010CCC00010CCC00010CCC00010CCC00010001
1101111111011111110111111101111111011111
1001C00100010001000100010001000100C10001
100100010000000100C100010001000100010001
10010CCC00010CCC00000CCC00010CCC00000001
1101111111011111110111111101111111011111
1001000100010000000100010001000100010001
10010CCC00010CCC00010CCC00010CCC00010001
10000000000000000000000000000000000000E1
1111111111111111111111111111111111111111