111111111111111111111111111111
1P0000C000000C000000C000000C01
101001001001C010010C1001001001
1011111111011110111111111C1101
100C00000000000000000000000001
101001001001001001001001001001
101001001001001001001001001001
101111111101111011111111101101
100000000000000000000000000001
101001001001001001001001001001
101001001001001001001001001001
101111111101111011111111101101
100000000000000000000000000001
1000000000000000000000000000E1
111111111111111111111111111111