11111111111111111111111111111
10P00000000000000000000000001
100C1100000110001111111110001
100C110CCC0110001111111110001
100C110CCC0110000000CC0110001
100C110CCC0110000000CC0110001
100C1100000110001111111110001
100C1111111110001111111110001
100C1111111110001100000000001
100CCCCCCCC1100011000000E0001
1000000000C110001100000000001
1000000000C110001111111110001
1000000000C110001111111110001
1000000000000C000000000000001
11111111111111111111111111111