111111
1P0C11
111101
1C00E1
111111
