1111111
1P00001
1011101
1C0C0E1
1000001
1111111