1111111
1P0C0E1
1010101
1CCC001
1011101
1000C01
1111111