1111111111111111111111111111111111111111
1P0000C00C0000C00C0000C00C0000C00C0000C1
1011111111110111111111110111111111111101
1C0000C00C0000C00C0000C00C0000C00C0000C1
1010111011101110111011101110111011101101
1C0C00C00C00C00C00C00C00C00C00C00C00C0C1
1011101110111011101110111011101110111101
1C0000C00C0000C00C0000C00C0000C00C0000C1
1010111011101110111011101110111011101101
1C0C00C00C00C00C00C00C00C00C00C00C00C0C1
1011101110111011101110111011101110111101
1C0000C00C0000C00C0000C00C0000C00C0000C1
1010111011101110111011101110111011101101
1C0C00C00C00C00C00C00C00C00C00C00C00C0C1
1011101110111011101110111011101110111101
1C0000C00C0000C00C0000C00C0000C00C0000C1
1011111111110111111111110111111111111101
1C0C0C0C0C0C0C0C0C0C0C0C0C0C0C0C0C0C0C01
10000000000000000000000000000000000000E1
1111111111111111111111111111111111111111